tags:JWW_FGB76_Grammar
What is the First Person Singular form of the Present Active Indicative of ἵστημι (στα) set make stand?	ἴ-στη-μι
What is the Second Person Singular form of the Present Active Indicative of ἵστημι (στα) set make stand?	ἴ-στη-ς
What is the Third Person Singular form of the Present Active Indicative of ἵστημι (στα) set make stand?	ἴ-στη-σι
What is the Second Person Dual form of the Present Active Indicative of ἵστημι (στα) set make stand?	ἴ-στα-τον
What is the Third Person Dual form of the Present Active Indicative of ἵστημι (στα) set make stand?	ἵ-στα-τον
What is the First Person Plural form of the Present Active Indicative of ἵστημι (στα) set make stand?	ἵ-στα-μεν
What is the Second Person Plural form of the Present Active Indicative of ἵστημι (στα) set make stand?	ἵ-στα-τε
What is the Third Person Plural form of the Present Active Indicative of ἵστημι (στα) set make stand?	ἱ-στᾶσι
What is the First Person Singular form of the Present Middle and Passive Indicative of ἵστημι (στα) set make stand?	ἴ-στα-μαι
What is the Second Person Singular form of the Present Middle and Passive Indicative of ἵστημι (στα) set make stand?	ἴ-στα-σαι
What is the Third Person Singular form of the Present Middle and Passive Indicative of ἵστημι (στα) set make stand?	ἴ-στα-ται
What is the Second Person Dual form of the Present Middle and Passive Indicative of ἵστημι (στα) set make stand?	ἴ-στα-σθον
What is the Third Person Dual form of the Present Middle and Passive Indicative of ἵστημι (στα) set make stand?	ἵ-στα-στά-σθην
What is the First Person Plural form of the Present Middle and Passive Indicative of ἵστημι (στα) set make stand?	ἱ-στά-μεθα
What is the Second Person Plural form of the Present Middle and Passive Indicative of ἵστημι (στα) set make stand?	ἵ-στα-σθε
What is the Third Person Plural form of the Present Middle and Passive Indicative of ἵστημι (στα) set make stand?	ἵ-στα-νται
What is the First Person Singular form of the Imperfect Active Indicative of ἵστημι (στα) set make stand?	ἴ-στη-ν
What is the Second Person Singular form of the Imperfect Active Indicative of ἵστημι (στα) set make stand?	ἴ-στη-ς
What is the Third Person Singular form of the Imperfect Active Indicative of ἵστημι (στα) set make stand?	ἴ-στη
What is the Second Person Dual form of the Imperfect Active Indicative of ἵστημι (στα) set make stand?	ἴ-στα-τον
What is the Third Person Dual form of the Imperfect Active Indicative of ἵστημι (στα) set make stand?	ἱ-στά-την
What is the First Person Plural form of the Imperfect Active Indicative of ἵστημι (στα) set make stand?	ἵ-στα-μεν
What is the Second Person Plural form of the Imperfect Active Indicative of ἵστημι (στα) set make stand?	ἵ-στα-τε
What is the Third Person Plural form of the Imperfect Active Indicative of ἵστημι (στα) set make stand?	ἵ-στα-σαν
What is the First Person Singular form of the Imperfect Middle and Passive Indicative of ἵστημι (στα) set make stand?	ἱ-στά-μην
What is the Second Person Singular form of the Imperfect Middle and Passive Indicative of ἵστημι (στα) set make stand?	ἴ-στα-σο
What is the Third Person Singular form of the Imperfect Middle and Passive Indicative of ἵστημι (στα) set make stand?	ἴ-στα-το
What is the Second Person Dual form of the Imperfect Middle and Passive Indicative of ἵστημι (στα) set make stand?	ἴ-στα-σθον
What is the Third Person Dual form of the Imperfect Middle and Passive Indicative of ἵστημι (στα) set make stand?	ἴ-στα-σθον
What is the First Person Plural form of the Imperfect Middle and Passive Indicative of ἵστημι (στα) set make stand?	ἱ-στά-μεθα
What is the Second Person Plural form of the Imperfect Middle and Passive Indicative of ἵστημι (στα) set make stand?	ἵ-στα-σθε
What is the Third Person Plural form of the Imperfect Middle and Passive Indicative of ἵστημι (στα) set make stand?	ἵ-στα-ντο
What is the First Person Singular form of the Present Active Subjunctive of ἵστημι (στα) set make stand?	ἱ-στῶ
What is the Second Person Singular form of the Present Active Subjunctive of ἵστημι (στα) set make stand?	ἱ-στῇς
What is the Third Person Singular form of the Present Active Subjunctive of ἵστημι (στα) set make stand?	ἱ-στῇ
What is the Second Person Dual form of the Present Active Subjunctive of ἵστημι (στα) set make stand?	ἱ-στῆ-τον
What is the Third Person Dual form of the Present Active Subjunctive of ἵστημι (στα) set make stand?	ἱ-στῆ-τον
What is the First Person Plural form of the Present Active Subjunctive of ἵστημι (στα) set make stand?	ἱ-στῶ-μεν
What is the Second Person Plural form of the Present Active Subjunctive of ἵστημι (στα) set make stand?	ἱ-στῆ-τε
What is the Third Person Plural form of the Present Active Subjunctive of ἵστημι (στα) set make stand?	ἱ-στῶσι
What is the First Person Singular form of the Present Middle and Passive Subjunctive of ἵστημι (στα) set make stand?	ἱ-στῶ-μαι
What is the Second Person Singular form of the Present Middle and Passive Subjunctive of ἵστημι (στα) set make stand?	ἱ-στῇ
What is the Third Person Singular form of the Present Middle and Passive Subjunctive of ἵστημι (στα) set make stand?	ἱ-στῆ-ται
What is the Second Person Dual form of the Present Middle and Passive Subjunctive of ἵστημι (στα) set make stand?	ἱ-στῆ-σθον
What is the Third Person Dual form of the Present Middle and Passive Subjunctive of ἵστημι (στα) set make stand?	ἱ-στῆ-σθον
What is the First Person Plural form of the Present Middle and Passive Subjunctive of ἵστημι (στα) set make stand?	ἱ-στώ-μεθα
What is the Second Person Plural form of the Present Middle and Passive Subjunctive of ἵστημι (στα) set make stand?	ἱ-στῆ-σθε
What is the Third Person Plural form of the Present Middle and Passive Subjunctive of ἵστημι (στα) set make stand?	ἱ-στῶ-νται
What is the First Person Singular form of the Present Active Optative of ἵστημι (στα) set make stand?	ἱ-σταίη-ν
What is the Second Person Singular form of the Present Active Optative of ἵστημι (στα) set make stand?	ἱ-σταίη-ς
What is the Third Person Singular form of the Present Active Optative of ἵστημι (στα) set make stand?	ἱ-σταίη
What is the Second Person Dual form of the Present Active Optative of ἵστημι (στα) set make stand?	ἱ-σταῖ-τον or ἱ-σταίη-τον
What is the Third Person Dual form of the Present Active Optative of ἵστημι (στα) set make stand?	ἱ-σταί-την or ἱ-σταίη-την
What is the First Person Plural form of the Present Active Optative of ἵστημι (στα) set make stand?	ἱ-σταῖ-μεν or ἱ-σταίη-μεν
What is the Second Person Plural form of the Present Active Optative of ἵστημι (στα) set make stand?	ἱ-σταῖ-τε or ἱ-σταίη-τε
What is the Third Person Plural form of the Present Active Optative of ἵστημι (στα) set make stand?	ἱ-σταῖε-ν or ἱ-σταίη-σαν
What is the First Person Singular form of the Present Middle and Passive Optative of ἵστημι (στα) set make stand?	ἱ-σταί-μην
What is the Second Person Singular form of the Present Middle and Passive Optative of ἵστημι (στα) set make stand?	ἱ-σταῖ-ο
What is the Third Person Singular form of the Present Middle and Passive Optative of ἵστημι (στα) set make stand?	ἱ-σταῖ-το
What is the Second Person Dual form of the Present Middle and Passive Optative of ἵστημι (στα) set make stand?	ἱ-σταῖ-σθον
What is the Third Person Dual form of the Present Middle and Passive Optative of ἵστημι (στα) set make stand?	ἱ-σταί-σθην
What is the First Person Plural form of the Present Middle and Passive Optative of ἵστημι (στα) set make stand?	ἱ-σταί-μεθα
What is the Second Person Plural form of the Present Middle and Passive Optative of ἵστημι (στα) set make stand?	ἱ-σταῖ-σθε
What is the Third Person Plural form of the Present Middle and Passive Optative of ἵστημι (στα) set make stand?	ἱ-σταῖ-ντο
What is the First Person Singular form of the Aorist Active Indicative of ἵστημι (στα) set make stand?	ἔ-στη-ν
What is the Second Person Singular form of the Aorist Active Indicative of ἵστημι (στα) set make stand?	ἔ-στη-ς
What is the Third Person Singular form of the Aorist Active Indicative of ἵστημι (στα) set make stand?	ἔ-στη
What is the Second Person Dual form of the Aorist Active Indicative of ἵστημι (στα) set make stand?	ἔ-στη-τον
What is the Third Person Dual form of the Aorist Active Indicative of ἵστημι (στα) set make stand?	ἐ-στή-την
What is the First Person Plural form of the Aorist Active Indicative of ἵστημι (στα) set make stand?	ἔ-στη-μεν
What is the Second Person Plural form of the Aorist Active Indicative of ἵστημι (στα) set make stand?	ἔ-στη-τε
What is the Third Person Plural form of the Aorist Active Indicative of ἵστημι (στα) set make stand?	ἔ-στη-σαν
What is the First Person Singular form of the Aorist Active Subjunctive of ἵστημι (στα) set make stand?	στῶ
What is the Second Person Singular form of the Aorist Active Subjunctive of ἵστημι (στα) set make stand?	στῇς
What is the Third Person Singular form of the Aorist Active Subjunctive of ἵστημι (στα) set make stand?	στῇ
What is the Second Person Dual form of the Aorist Active Subjunctive of ἵστημι (στα) set make stand?	στῆ-τον
What is the Third Person Dual form of the Aorist Active Subjunctive of ἵστημι (στα) set make stand?	στῆ-τον
What is the First Person Plural form of the Aorist Active Subjunctive of ἵστημι (στα) set make stand?	στῶ-μεν
What is the Second Person Plural form of the Aorist Active Subjunctive of ἵστημι (στα) set make stand?	στῆ-τε
What is the Third Person Plural form of the Aorist Active Subjunctive of ἵστημι (στα) set make stand?	στῶσι
What is the First Person Singular form of the Aorist Active Optative of ἵστημι (στα) set make stand?	σταίη-ν
What is the Second Person Singular form of the Aorist Active Optative of ἵστημι (στα) set make stand?	σταίη-ς
What is the Third Person Singular form of the Aorist Active Optative of ἵστημι (στα) set make stand?	σταίη
What is the Second Person Dual form of the Aorist Active Optative of ἵστημι (στα) set make stand?	σταῖ-τον or σταίη-τον
What is the Third Person Dual form of the Aorist Active Optative of ἵστημι (στα) set make stand?	σταί-την or σταιή-την
What is the First Person Plural form of the Aorist Active Optative of ἵστημι (στα) set make stand?	σταῖ-μεν or σταίη-μεν
What is the Second Person Plural form of the Aorist Active Optative of ἵστημι (στα) set make stand?	σταῖ-τε or σταίη-τε
What is the Third Person Plural form of the Aorist Active Optative of ἵστημι (στα) set make stand?	σταῖε-ν or σταίη-σαν
