tags:JWW_FGB72_Vocabulary
What does βιαίως (cf. βιάζομαι) mean?	adv. violently.
What does ἑξακόσιοι αι α mean?	600.
What does κονιορτός οῦ ὁ mean?	cloud of dust.
What does λευκός ή όν mean?	white.
What does μέχρι mean?	conj. until.
What does νεφέλη ης ἡ mean?	cloud.
What does νεκρός οῦ ὁ mean?	corpse; οἱ νεκροί the dead.
What does παλτόν οῦ τό mean?	spear javelin.
What does τροπή ῆς ἡ (cf. τρέπω) mean?	rout defeat.
What does ὑστεραῖος ᾱ ον (cf. ὕστερος) mean?	later following.
What is the Greek word for adv. violently?	βιαίως (cf. βιάζομαι)
What is the Greek word for 600?	ἑξακόσιοι αι α
What is the Greek word for cloud of dust?	κονιορτός οῦ ὁ
What is the Greek word for white?	λευκός ή όν
What is the Greek word for conj. until?	μέχρι
What is the Greek word for cloud?	νεφέλη ης ἡ
What is the Greek word for corpse; οἱ νεκροί the dead?	νεκρός οῦ ὁ
What is the Greek word for spear javelin?	παλτόν οῦ τό
What is the Greek word for rout defeat?	τροπή ῆς ἡ (cf. τρέπω)
What is the Greek word for later following?	ὑστεραῖος ᾱ ον (cf. ὕστερος)
