tags:JWW_FGB74_Grammar
What is the First Person Singular form of the Present Active Indicative of τίθημι (θε) place put?	τί-θη-μι
What is the Second Person Singular form of the Present Active Indicative of τίθημι (θε) place put?	τί-θη-ς
What is the Third Person Singular form of the Present Active Indicative of τίθημι (θε) place put?	τί-θη-σι
What is the Second Person Dual form of the Present Active Indicative of τίθημι (θε) place put?	τί-θε-τον
What is the Third Person Dual form of the Present Active Indicative of τίθημι (θε) place put?	τί-θε-τον
What is the First Person Plural form of the Present Active Indicative of τίθημι (θε) place put?	τί-θε-μεν
What is the Second Person Plural form of the Present Active Indicative of τίθημι (θε) place put?	τί-θε-τε
What is the Third Person Plural form of the Present Active Indicative of τίθημι (θε) place put?	τι-θέ-ᾱσι
What is the First Person Singular form of the Imperfect Active Indicative of τίθημι (θε) place put?	ἐ-τί-θη-ν
What is the Second Person Singular form of the Imperfect Active Indicative of τίθημι (θε) place put?	ἐ-τί-θεις
What is the Third Person Singular form of the Imperfect Active Indicative of τίθημι (θε) place put?	ἐ-τί-θει
What is the Second Person Dual form of the Imperfect Active Indicative of τίθημι (θε) place put?	ἐ-τί-θε-τον
What is the Third Person Dual form of the Imperfect Active Indicative of τίθημι (θε) place put?	ἐ-τι-θέ-την
What is the First Person Plural form of the Imperfect Active Indicative of τίθημι (θε) place put?	ἐ-τί-θε-μεν
What is the Second Person Plural form of the Imperfect Active Indicative of τίθημι (θε) place put?	ἐ-τί-θε-τε
What is the Third Person Plural form of the Imperfect Active Indicative of τίθημι (θε) place put?	ἐ-τί-θε-σαν
What is the First Person Singular form of the Imperfect Active Indicative of τίθημι (θε) place put?	τί-θε-μαι
What is the Second Person Singular form of the Imperfect Active Indicative of τίθημι (θε) place put?	τί-θε-σαι
What is the Third Person Singular form of the Imperfect Active Indicative of τίθημι (θε) place put?	τί-θε-ται
What is the Second Person Dual form of the Imperfect Active Indicative of τίθημι (θε) place put?	τί-θε-σθον
What is the Third Person Dual form of the Imperfect Active Indicative of τίθημι (θε) place put?	τί-θε-σθον
What is the First Person Plural form of the Imperfect Active Indicative of τίθημι (θε) place put?	τι-θέ-μεθα
What is the Second Person Plural form of the Imperfect Active Indicative of τίθημι (θε) place put?	τί-θε-σθε
What is the Third Person Plural form of the Imperfect Active Indicative of τίθημι (θε) place put?	τί-θε-νται
What is the First Person Singular form of the Imperfect Middle and Passive Indicative of τίθημι (θε) place put?	ἐ-τι-θέ-μην
What is the Second Person Singular form of the Imperfect Middle and Passive Indicative of τίθημι (θε) place put?	ἐ-τί-θε-σο
What is the Third Person Singular form of the Imperfect Middle and Passive Indicative of τίθημι (θε) place put?	ἐ-τί-θε-το
What is the Second Person Dual form of the Imperfect Middle and Passive Indicative of τίθημι (θε) place put?	ἐ-τί-θε-σθον
What is the Third Person Dual form of the Imperfect Middle and Passive Indicative of τίθημι (θε) place put?	ἐ-τι-θέ-σθην
What is the First Person Plural form of the Imperfect Middle and Passive Indicative of τίθημι (θε) place put?	ἐ-τι-θέ-μεθα
What is the Second Person Plural form of the Imperfect Middle and Passive Indicative of τίθημι (θε) place put?	ἐ-τί-θε-σθε
What is the Third Person Plural form of the Imperfect Middle and Passive Indicative of τίθημι (θε) place put?	ἐ-τί-θε-ντο
What is the First Person Singular form of the Present Active Subjunctive of τίθημι (θε) place put?	τι-θῶ
What is the Second Person Singular form of the Present Active Subjunctive of τίθημι (θε) place put?	τι-θῇς
What is the Third Person Singular form of the Present Active Subjunctive of τίθημι (θε) place put?	τι-θῇ
What is the Second Person Dual form of the Present Active Subjunctive of τίθημι (θε) place put?	τι-θῆ-τον
What is the Third Person Dual form of the Present Active Subjunctive of τίθημι (θε) place put?	τι-θῆ-τον
What is the First Person Plural form of the Present Active Subjunctive of τίθημι (θε) place put?	τι-θῶ-μεν
What is the Second Person Plural form of the Present Active Subjunctive of τίθημι (θε) place put?	τι-θῆ-τε
What is the Third Person Plural form of the Present Active Subjunctive of τίθημι (θε) place put?	τι-θῶσι
What is the First Person Singular form of the Present Middle and Passive Subjunctive of τίθημι (θε) place put?	τι-θῶ-μαι
What is the Second Person Singular form of the Present Middle and Passive Subjunctive of τίθημι (θε) place put?	τι-θῇ
What is the Third Person Singular form of the Present Middle and Passive Subjunctive of τίθημι (θε) place put?	τι-θῆ-ται
What is the Second Person Dual form of the Present Middle and Passive Subjunctive of τίθημι (θε) place put?	τι-θῆ-σθον
What is the Third Person Dual form of the Present Middle and Passive Subjunctive of τίθημι (θε) place put?	τι-θῆ-σθον
What is the First Person Plural form of the Present Middle and Passive Subjunctive of τίθημι (θε) place put?	τι-θώ-μεθα
What is the Second Person Plural form of the Present Middle and Passive Subjunctive of τίθημι (θε) place put?	τι-θῆ-σθε
What is the Third Person Plural form of the Present Middle and Passive Subjunctive of τίθημι (θε) place put?	τι-θῶ-νται
What is the First Person Singular form of the Present Active Optative of τίθημι (θε) place put?	τι-θείη-ν
What is the Second Person Singular form of the Present Active Optative of τίθημι (θε) place put?	τι-θείη-ς
What is the Third Person Singular form of the Present Active Optative of τίθημι (θε) place put?	τι-θείη
What is the Second Person Dual form of the Present Active Optative of τίθημι (θε) place put?	τι-θεῖ-τον or τι-θείη-τον
What is the Third Person Dual form of the Present Active Optative of τίθημι (θε) place put?	τι-θεί-την τι-θειή-την
What is the First Person Plural form of the Present Active Optative of τίθημι (θε) place put?	τι-θεῖ-μεν τι-θείη-μεν
What is the Second Person Plural form of the Present Active Optative of τίθημι (θε) place put?	τι-θεῖ-τε τι-θείη-τε
What is the Third Person Plural form of the Present Active Optative of τίθημι (θε) place put?	τι-θεῖε-ν τι-θείη-σαν
What is the First Person Singular form of the Present Middle and Passive Optative of τίθημι (θε) place put?	τι-θεί-μην
What is the Second Person Singular form of the Present Middle and Passive Optative of τίθημι (θε) place put?	τι-θεῖ-ο
What is the Third Person Singular form of the Present Middle and Passive Optative of τίθημι (θε) place put?	τι-θεῖ-το
What is the Second Person Dual form of the Present Middle and Passive Optative of τίθημι (θε) place put?	τι-θεῖ-σθον
What is the Third Person Dual form of the Present Middle and Passive Optative of τίθημι (θε) place put?	τι-θεί-σθην
What is the First Person Plural form of the Present Middle and Passive Optative of τίθημι (θε) place put?	τι-θεί-μεθα
What is the Second Person Plural form of the Present Middle and Passive Optative of τίθημι (θε) place put?	τι-θεῖ-σθε
What is the Third Person Plural form of the Present Middle and Passive Optative of τίθημι (θε) place put?	τι-θεῖ-ντο
What is the First Person Singular  form of the Aorist Active Indicative of τίθημι (θε) place put?	ἔθηκα
What is the Second Person Singular form of the Aorist Active Indicative of τίθημι (θε) place put?	ἔθηκας
What is the Third Person Singular form of the Aorist Active Indicative of τίθημι (θε) place put?	ἔθηκε
What is the Second Person Dual form of the Aorist Active Indicative of τίθημι (θε) place put?	ἔ-θε-τον
What is the Third Person Dual form of the Aorist Active Indicative of τίθημι (θε) place put?	ἔ-θέ-την
What is the First Person Plural form of the Aorist Active Indicative of τίθημι (θε) place put?	ἔ-θε-μεν
What is the Second Person Plural form of the Aorist Active Indicative of τίθημι (θε) place put?	ἔ-θε-τε
What is the Third Person Plural form of the Aorist Active Indicative of τίθημι (θε) place put?	ἔ-θε-σαν
What is the First Person Singular  form of the Aorist Middle and Passive Indicative of τίθημι (θε) place put?	ἐ-θέ-μην
What is the Second Person Singular form of the Aorist Middle and Passive Indicative of τίθημι (θε) place put?	ἔ-θου
What is the Third Person Singular form of the Aorist Middle and Passive Indicative of τίθημι (θε) place put?	ἔ-θε-το
What is the Second Person Dual form of the Aorist Middle and Passive Indicative of τίθημι (θε) place put?	ἔ-θε-σθον
What is the Third Person Dual form of the Aorist Middle and Passive Indicative of τίθημι (θε) place put?	ἐ-θέ-σθην
What is the First Person Plural form of the Aorist Middle and Passive Indicative of τίθημι (θε) place put?	ἐ-θέ-μεθα
What is the Second Person Plural form of the Aorist Middle and Passive Indicative of τίθημι (θε) place put?	ἔ-θε-σθε
What is the Third Person Plural form of the Aorist Middle and Passive Indicative of τίθημι (θε) place put?	ἔ-θε-ντο
What is the First Person Singular form of the Aorist Active Subjunctive of τίθημι (θε) place put?	θῶ
What is the Second Person Singular form of the Aorist Active Subjunctive of τίθημι (θε) place put?	θῇς
What is the Third Person Singular form of the Aorist Active Subjunctive of τίθημι (θε) place put?	θῇ
What is the Second Person Dual form of the Aorist Active Subjunctive of τίθημι (θε) place put?	θῆ-τον
What is the Third Person Dual form of the Aorist Active Subjunctive of τίθημι (θε) place put?	θῆ-τον
What is the First Person Plural form of the Aorist Active Subjunctive of τίθημι (θε) place put?	θῶ-μεν
What is the Second Person Plural form of the Aorist Active Subjunctive of τίθημι (θε) place put?	θῆ-τε
What is the Third Person Plural form of the Aorist Active Subjunctive of τίθημι (θε) place put?	θῶσι
What is the First Person Singular form of the Aorist Middle and Passive Subjunctive of τίθημι (θε) place put?	θῶ-μαι
What is the Second Person Singular form of the Aorist Middle and Passive Subjunctive of τίθημι (θε) place put?	θῇ
What is the Third Person Singular form of the Aorist Middle and Passive Subjunctive of τίθημι (θε) place put?	θῆ-ται
What is the Second Person Dual form of the Aorist Middle and Passive Subjunctive of τίθημι (θε) place put?	θῆ-σθον
What is the Third Person Dual form of the Aorist Middle and Passive Subjunctive of τίθημι (θε) place put?	θῆ-σθον
What is the First Person Plural form of the Aorist Middle and Passive Subjunctive of τίθημι (θε) place put?	θώ-μεθα
What is the Second Person Plural form of the Aorist Middle and Passive Subjunctive of τίθημι (θε) place put?	θῆ-σθε
What is the Third Person Plural form of the Aorist Middle and Passive Subjunctive of τίθημι (θε) place put?	θῶ-νται
What is the First Person Singular form of the Aorist Active Optative of τίθημι (θε) place put?	θείη-ν
What is the Second Person Singular form of the Aorist Active Optative of τίθημι (θε) place put?	θείη-ς
What is the Third Person Singular form of the Aorist Active Optative of τίθημι (θε) place put?	θείη
What is the Second Person Dual form of the Aorist Active Optative of τίθημι (θε) place put?	θεῖ-τον or θείη-τον
What is the Third Person Dual form of the Aorist Active Optative of τίθημι (θε) place put?	θεί-την or θειή-την
What is the First Person Plural form of the Aorist Active Optative of τίθημι (θε) place put?	θεῖ-μεν or θείη-μεν
What is the Second Person Plural form of the Aorist Active Optative of τίθημι (θε) place put?	θεῖ-τε or θείη-τε
What is the Third Person Plural form of the Aorist Active Optative of τίθημι (θε) place put?	θεῖε-ν or θείη-σαν
What is the First Person Singular form of the Aorist Middle and Passive Optative of τίθημι (θε) place put?	θεί-μην
What is the Second Person Singular form of the Aorist Middle and Passive Optative of τίθημι (θε) place put?	θεῖ-ο
What is the Third Person Singular form of the Aorist Middle and Passive Optative of τίθημι (θε) place put?	θεῖ-το
What is the Second Person Dual form of the Aorist Middle and Passive Optative of τίθημι (θε) place put?	θεῖ-σθον
What is the Third Person Dual form of the Aorist Middle and Passive Optative of τίθημι (θε) place put?	θεί-σθην
What is the First Person Plural form of the Aorist Middle and Passive Optative of τίθημι (θε) place put?	θεί-μεθα
What is the Second Person Plural form of the Aorist Middle and Passive Optative of τίθημι (θε) place put?	θεῖ-σθε
What is the Third Person Plural form of the Aorist Middle and Passive Optative of τίθημι (θε) place put?	θεῖ-ντο
